MK11 = MK11
re7 = Residen Evil 7
RDR2 = RDR2
TslGame = PUBG   
warframe = Warframe
FortniteClient-Win64-Shipping = Fortnite
FallGuys_client_game = Fall Guys
game = Caliber
Caliber = Caliber
Ow2 = Overwatch 2
Overwatch = Overwatch 2
WorldOfTanks = World Of Tanks
APlagueTaleInnocence_x64 = A Plague Tale Innocence
AI = Alien Isolation
cod = Call of Duty HQ warzone 2
DetroitBecomeHuman = Detroit Become Human
DOOMx64 = DOOM
DOOMx64vk = DOOM 
DyingLightGame = Dying Light
FarCry5 = FarCry 5
GTA5 = GTA 5
HogwartsLegacy = Hogwarts Legacy
MetroExodus = Metro Exodus
NMS = No Mans Sky
Kingmaker = Pathfinder Kingmaker
Wrath = Pathfinder Second Adventure
Prey = Prey
re3 = Resident Evil 3
re2 = RESIDENT EVIL 2
ROTTR = Rise of the Tomb Raider
SOTTR = Shadow of the Tomb Raider
witcher2 = The Witcher 2
TombRaider = Tomb Raider
wwzRetail = World War Z
cs2 = Counter-Strike 2
Cyberpunk2077 = Cyberpunk 2077
DeadByDaylight = Dead by Daylight
dota2 = Dota 2
raft = Raft
witcher3 = The Witcher 3
r5apex = Apex Legends
metro = Metro
TheForest = The Forest
tld = The Long Dark
DarkSoulsIII = DARK SOULS III
PathOfExileSteam = Path of Exile
RimWorldWin64 = RimWorld
Rust = Rust
underlords = Dota Underlords
rdr = Red Dead Redempion 2
ACOdyssey = "Assasins Creed Odyssey"
ACOrigins = "Assassins Creed Origins"
EoCApp = Divinity Original Sin 2
ShadowOfWar = Middle-earth Shadow of War
wl3 = Wasteland 3
soma = Soma
Quantumbreak = Quantum Break
Paladins = Paladins
payday2_win32_release = Payday 2
AlanWake = Alan Wake
DeathStranding = Death Stranding
eldenring = Elden Ring
enlisted = Enlisted
BatmanAK = Batman Arkham Knight
payday2_win32_release.exe = Payday 2
oriDE = Ori DE
forhonor = For Honor
Mordhau-Win64-Shipping = Mordhau
smite = Smite
propnight = Propnight
theDivision2 = The Division 2
Prospect-Win64-Shipping = The Cycle Frontier
ForzaHorizon4 = Forza Horizon 4
Fallout76 = Fallout 76
7DaysToDie = 7 Days To Die
valheim = Valheim
SnowRunner = SnowRunner
HuntGame = Hunt Showdown
Phasmophobia = Phasmophobia
sogame = Stay Out
MassEffectAndromeda = Mass Effect Andromeda
RocketLeague = Rocket League
Subnautica = Subnautica
bg3_dx11 = Baldur`s Gate 3
NFS16 = Need for Speed
RainbowSix = Tom Clancys Rainbow Six Siege
SoTGame = Sea of Thieves
Crossout = Crossout
FarCry6 = Far Cry 6
destiny2 = Destiny 2
SquadGame = Squad
Dungeonhaven-Win64-Shipping = Mortal Shell
Game_x64r = Lost Light
Titanfall2 = Titanfall 2
20XX = 20XX
ACValhalla = Assassins Creed Valhalla
Watch_Dogs = Watch Dogs
WatchDogs2 = Watch Dogs 2
WatchDogsLegion = Watch Dogs Legion
BF2042 = Battlefield 2042
bfv = Battlefield V
bf1 = Battlefield 1
tlou-i = The Last of Us Part I
NewWorld = New World
DCS = DCS World
EscapeFromTarkov = Escape From Tarkov
Borderlands3 = Borderlands 3
Warframe.x64 = Warframe
HorizonZeroDawn = Horizon Zero Dawn
ACCGame-Win32-Shipping = Assassins Creed Chronicles: China
ACU = Assassins Creed Chronicles: Unity
rf4_x64 = Russian Fishing 4
ForzaHorizon5 = Forza Horizon 5
DaysGone = Days Gone
Stray-Win64-Shipping = Stray
shootergame = ARK: Survival evolved
AСS = Assassin`s Creed Syndicate
GlyphEngine = War Selection
Blairwitch-Win64-Shipping = Blair Witch
FTK = For The King
GRW = Tom Clancy`s Ghost Recon Wildlands
hl2 = Team Fortress 2
Control_DX12 = Control
SMITE = SMITE
SolarlandClient-Win64-Shipping = Farlight 84
starwarssquadrons = STAR WARS: Squadrons
awayout = A Way Out
AC7 = ACE COMBAT 7: SKIES UNKNOWN
AshesEscalation = Ashes of the Singularity: Escalation
ACCChina = Assassin's Creed Chronicles: China
Automachef = Automachef
BFBC2Game = Battlefield: Bad Company 2
Battlerite = Battlerite
BeyondTwoSouls = Beyond: Two Souls
BlackDesertOnline = Black Desert
bms = Black Mesa
blacksquad = Black Squad
Borderlands2 = Borderlands 2
Brawlhalla = Brawlhalla
CRSED = CRSED: F.O.A.D.
BC_TWD = Bridge Constructor: The Walking Dead
ModernWarfare = Call of Duty: Modern Warfare II
Century - Age of Ashes = Century: Age of Ashes
CityOfBrass = City of Brass
CloseToTheSun = Close to the Sun
Conarium = Conarium
Control = Control
CreatureInTheWell = Creature in the Well
CryingSuns = Crying Suns
Cyberpunk2077PhantomLiberty = Cyberpunk 2077: Phantom Liberty
Dagon = Dagon: by H.P. Lovecraft
Deceit = Deceit
DefenseGrid = Defense Grid: The Awakening
DXHRDC = Deus Ex: Human Revolution - Director's Cut
DeusExMD = Deus Ex: Mankind Divided
DevilMayCry5 = Devil May Cry 5
Diablo3 = Diablo III
Distrust = Distrust: Polar Survival
DOOM = DOOM
Dungeons3 = Dungeons 3
DyingLight = Dying Light
DyingLight2 = Dying Light 2 Stay Human
DLBadBlood = Dying Light: Bad Blood
eFootball2024 = eFootball 2024
EnterTheGungeon = Enter the Gungeon
EternalReturn = Eternal Return: Black Survival
eurotrucks2 = Euro Truck Simulator 2
EvilDead = Evil Dead: The Game
F12020 = F1 2020
FallGuys = Fall Guys
Fallout4 = Fallout 4
FarCryNewDawn = Far Cry New Dawn
Farlight84 = Farlight 84
FIFA22 = FIFA 22
ForTheKing = For The King
Fortnite = Fortnite
Frostpunk = Frostpunk
GalacticCivilizations3 = Galactic Civilizations III
Gears5 = Gears 5
GhostExile = Ghost Exile
GodOfWar = God of War
GodlikeBurger = Godlike Burger
GooseGooseDuck = Goose Goose Duck
GRID = GRID (2019)
Halcyon6 = Halcyon 6: Lightspeed Edition
episodic = Half-Life 2: Episode One
ep2 = Half-Life 2: Episode Two
HeavyRain = Heavy Rain
HeroesAndGenerals = Heroes & Generals
HITMAN = HITMAN
HITMAN3 = HITMAN 3
HITMAN2 = HITMAN™ 2
HonkaiStarRail = Honkai: Star Rail
Inside = Inside
ItTakesTwo = It Takes Two Friend's Pass
IXION = IXION
JustCause4 = Just Cause 4
KFGame = Killing Floor 2
KingdomCome = Kingdom Come: Deliverance
left4dead2 = Left for Dead 2
LifeIsStrange = Life is Strange
LifeIsStrange2 = Life is Strange 2
LifeIsStrangeBTS = Life is Strange: Before the Storm
LimbusCompany = Limbus Company
LittleNightmares = Little Nightmares
LoopHero = Loop Hero
lotf = Lords Of The Fallen
LostLight = Lost Light
MWO = MechWarrior Online
MetroRedux = Metro 2033 Redux
MetroExodusEE = Metro Exodus Enhanced Edition
LastLightRedux = Metro: Last Light Redux
MirrorsEdgeCatalyst = Mirror’s Edge: Catalyst
Mordhau = MORDHAU
MortalShell = Mortal Shell
MovingOut = Moving Out
MudRunner = MudRunner
ZoneUE4 = Mutant Year Zero Road to Eden
MyHeroUltraRumble = MY HERO ULTRA RUMBLE
NBA2K21 = NBA 2K21
NFS = Need for Speed™
NeonAbyss = Neon Abyss
Neverwinter = Neverwinter
Overcooked = Overcooked!
Overwatch2 = Overwatch 2
Pacify = Pacify
Panzar = Panzar
PathOfExile = Path of Exile
PathfinderKingmaker = Pathfinder: Kingmaker - Enhanced Plus Edition
PathfinderWrath = Pathfinder: Wrath of the Righteous
Pathologic2 = Pathologic 2
PCBuildingSimulator = PC Building Simulator
PhantomDoctrine = Phantom Doctrine
PlanetSide2 = PlanetSide 2
portal2 = Portal 2
QuakeChampions = Quake Champions
RAGE2 = RAGE 2
RailwayEmpire = Railway Empire
RAMPressure = RAM Pressure
ReadyOrNot = Ready or Not
Relicta = Relicta
re_resistance = Resident Evil Resistance
ROELauncher = Ring of Elysium
ROTTR20 = Rise of the Tomb Raider: 20 Year Celebration
Robocraft = Robocraft
RogueCompany = Rogue Company
ruiner = RUINER
RussianFishing4 = Russian Fishing 4
saintsrow = Saints Row: The Third — Remastered
SamuraiShodownNEOGEO = SAMURAI SHODOWN NEOGEO COLLECTION
FactoryGame = Satisfactory
SCPSL = SCP: Secret Laboratory
SCUM = SCUM
Tales_Client_WinApp = Sea of Thieves
SecondExtinction = Second Extinction
ShadowOfTheTombRaider = Shadow of the Tomb Raider
ShadowTactics = Shadow Tactics — Aiko's Choice
SonsOfTheForest = Sons Of The Forest
SpellForce3 = SpellForce 3: Versus Edition
PortalWars-Win64-Shipping = Splitgate
Squad = Squad
StarConflict = Star Conflict
SwGame = STAR WARS Jedi: Fallen Order™
StarWarsBattlefrontII = STAR WARS™ Battlefront™ II
Starlink = Starlink: Battle for Atlas
StayOut = Stay Out
Steep = Steep
Stray = Stray
SuccubusPrologue = SUCCUBUS: Prologue
SurvivingMars = Surviving Mars
Tacoma = Tacoma
TheCycle = The Cycle: Frontier
eso = The Elder Scrolls Online
TheEscapist2 = The Escapists 2
TLOU = The Last of Us: Part I
TS4 = The Sims 4
Shogun2 = Total War: SHOGUN 2
Trials_Rising = Trials Rising
Bloodhunt = Vampire: The Masquerade - Bloodhunt
WarSelection = War Selection
WatchDogs = Watch Dogs
NewColossus_x64vk = Wolfenstein II: The New Colossus
Wolfenstein_YB_x64vk = Wolfenstein: Youngblood
WorldOfWarships = World of Warships
SaberClient-Win64-Shipping = World War Z
SaberClient-Win64-Shipping = World War Z: Aftermath
YookaLayleeImpossibleLair = Yooka-Laylee and the Impossible Lair
FrenzyRetribution = FrenzyRetribution
